1 4 199 235 575 321 
1 4 108 833 60 199 
1 2 686 108 
1 2 105 686 
1 6 175 59 607 82 167 105 
1 3 675 393 686 
1 2 628 675 
1 3 131 829 628 
1 3 405 812 131 
1 4 671 328 248 405 
1 2 85 671 
1 3 85 671 160 
1 3 85 315 160 
1 4 837 328 671 85 
1 3 85 626 654 
1 3 85 836 654 
1 5 677 232 646 834 654 
1 2 442 321 
1 5 840 520 276 759 442 
1 2 154 442 
1 3 552 612 154 
1 4 346 488 688 552 
1 2 346 687 
1 3 602 304 687 
1 3 602 141 331 
1 4 304 342 169 430 
1 3 314 169 430 
1 6 552 24 849 89 109 786 
1 2 31 786 
1 2 698 786 
1 4 138 510 573 698 
1 3 744 1 138 
1 3 46 756 138 
1 5 756 172 57 622 236 
1 3 744 441 443 
1 3 775 726 443 
1 2 775 121 
1 3 382 130 775 
1 3 775 279 471 
1 3 471 619 746 
1 4 471 416 107 79 
1 3 79 272 353 
1 3 400 780 353 
1 3 442 400 274 
1 2 321 400 
1 3 511 350 506 
1 2 511 506 
1 9 793 202 782 324 552 612 154 442 321 
1 8 618 541 500 833 60 235 575 321 
1 7 839 219 695 190 604 502 321 
1 10 321 702 531 607 307 12 631 335 819 710 
1 10 321 274 472 97 416 471 848 441 310 261 
1 8 770 631 12 307 607 531 702 321 
1 14 321 502 435 360 9 645 418 28 140 579 290 800 319 551 
1 6 321 702 531 745 144 246 
1 7 321 274 472 474 219 839 284 
1 12 321 442 283 136 846 688 546 639 260 755 608 361 
1 12 321 274 472 97 416 471 204 1 46 756 600 193 
1 14 321 274 472 97 416 471 204 1 46 756 600 193 658 230 
1 10 321 702 531 607 307 12 631 335 819 710 
1 14 321 502 435 360 9 645 418 28 140 579 290 800 319 551 
1 8 321 442 283 136 277 475 32 182 
1 9 196 823 648 175 144 360 604 502 321 
1 9 321 274 472 699 841 528 150 340 151 
1 12 321 442 283 136 846 688 546 639 260 755 608 361 
1 8 321 274 472 97 416 471 204 1 
1 10 95 138 746 619 348 107 844 316 274 321 
1 12 263 600 756 138 746 619 348 107 844 316 274 321 
1 14 321 274 472 97 416 471 204 1 46 756 600 193 658 230 
1 10 637 419 555 207 513 860 195 356 750 7 
